17 20
1 1 1 1 1 1 1 1 1 1 1 1 1 1 1 1 1 1 1 1
1 2 0 0 0 0 1 0 2 1 3 1 0 0 0 0 1 2 0 1
1 0 0 1 1 0 1 0 1 1 0 1 0 1 1 0 1 0 0 1
1 1 1 1 0 0 1 0 1 0 0 1 0 1 1 0 1 1 0 1
1 0 0 0 0 1 1 0 1 0 1 1 0 1 0 0 0 0 0 1
1 0 0 1 0 1 0 0 1 0 1 0 0 1 0 0 1 1 1 1
1 0 1 1 0 0 0 0 1 0 0 0 0 1 1 0 0 0 0 1 
1 0 1 0 0 1 1 0 1 1 1 0 1 1 0 0 1 0 2 1
1 0 1 1 1 1 0 0 0 1 1 2 1 0 0 0 1 1 1 1
1 0 0 1 0 0 0 0 1 1 1 1 1 1 0 0 0 0 0 1
1 1 0 1 0 1 1 1 1 1 2 1 1 0 0 0 1 1 0 1
1 0 0 1 0 0 0 0 1 1 0 1 0 0 0 1 1 2 0 1
1 0 1 1 1 1 1 0 1 1 0 1 1 0 0 1 0 0 0 1
1 0 0 0 0 0 1 0 0 0 0 1 1 0 0 0 0 0 0 1 
1 0 0 0 0 0 1 1 1 1 1 1 1 1 0 0 1 1 1 1
1 0 0 0 0 0 0 0 0 0 0 0 0 0 0 0 0 0 0 1
1 1 1 1 1 1 1 1 1 1 1 1 1 1 1 1 1 1 1 1
2 5 2 5
8 15 10 16
15 3 15 5

      